0 0 0 0 0 0 0 0 0 1 0 0 0 0 
0 0 0 0 0 0 5 0 0 0 0 0 0 0 
0 0 0 0 0 0 0 0 -2 -2 0 0 0 0 
0 0 0 101 101 0 0 0 0 0 0 0 0 0 
0 0 0 101 101 0 0 0 0 0 0 0 0 0 
0 2 0 0 0 0 0 0 0 0 0 0 0 0 
0 -1 -1 0 0 0 0 0 7 0 0 0 -3 -3 
0 -1 -1 0 0 4 0 6 0 0 0 0 -3 -3 
0 0 0 0 0 0 0 0 0 0 3 0 0 0 
0 0 0 0 0 0 -4 -4 0 0 0 0 0 0 
0 0 0 0 0 0 -4 -4 0 100 0 0 0 0 
0 0 0 0 0 0 0 0 0 100 0 0 -5 -5 
0 0 0 0 0 0 0 0 0 100 0 0 0 0 
0 0 0 0 0 0 0 0 0 0 0 0 0 0 
