0 0 0 0 14 0 0 0 0 0 0 0 0 0 0 10 8 0 
0 0 0 0 0 0 0 0 7 3 0 0 0 0 0 0 0 0 
0 0 0 0 0 0 0 0 -2 -2 0 0 0 0 0 -7 -7 0 
0 0 0 101 101 101 101 0 9 0 0 0 0 0 0 -7 -7 0 
0 0 0 101 101 101 101 0 0 0 0 0 0 0 0 0 0 0 
0 0 0 0 0 0 0 0 0 0 0 0 0 0 11 0 0 0 
0 -1 -1 0 0 2 0 0 0 0 0 0 -3 -3 12 0 0 0 
0 -1 -1 0 0 0 0 0 0 0 0 0 -3 -3 0 0 0 0 
0 0 0 0 0 0 0 4 0 0 0 0 0 0 0 0 0 0 
0 0 0 0 0 0 -4 -4 0 0 0 0 0 0 0 0 0 0 
0 0 0 0 0 0 -4 -4 0 100 100 0 0 0 0 0 0 0 
0 0 0 0 0 0 6 0 0 100 100 0 -5 -5 0 0 -8 -8 
0 0 0 0 0 0 0 1 0 100 100 0 0 0 0 0 0 0 
0 0 0 0 0 0 0 0 0 0 0 5 0 13 0 0 0 0 
0 0 0 0 0 0 0 0 0 0 0 0 0 0 0 0 0 0 
0 0 0 0 0 0 0 0 0 0 0 0 0 0 0 0 0 0 
0 0 0 0 0 0 0 0 0 0 0 0 -6 -6 0 0 0 0 
0 0 0 0 0 0 0 0 0 0 0 0 -6 -6 0 0 0 0 
